#### Main Section ####################################
index=common.IndexController
survey=common.ServeyController
payOk=common.test
#### Member Section ##################################
melogin=member.MemberLoginController
melogout=member.MemberLogoutController
mypage=member.MemberMypageController
newmember=member.MemberNewmemberController
coupon=member.MyCouponController
idcheck=member.IdcheckController
memodify=member.MemberModifyController
order=member.OrderListcontroller
point=member.MyPointController
address=member.Addresscontroller
addaddress=member.Addaddresscontroller
meZipcheck=member.MemberZipchekcontroller
melogout=member.MemberLogoutController
#### CS-Center Section ###############################
cs_center_main=CS.NoticeListController
cs_center_main_asked=CS.AskedListController
notice_detailview=CS.NoticeDetailViewController
notice_update=CS.NoticeUpdateController
notice_insert=CS.NoticeInsertController
notice_delete=CS.NoticeDeleteController
asked_insert=CS.AskedInsertController
asked_update=CS.AskedUpdateController
asked_detailview=CS.AskedDetailViewController
asked_delete=CS.AskedDeleteController
#### Customer Section ################################
boInsert=board.BoardInsertController
boList=board.BoardListController
bbsdetailview=board.BoardDetailViewController
boDelete=board.BoardDeleteController
boUpdate=board.BoardUpdateController
comment=board.commentInsertController
like=board.bbslikeController
#### Product Section #################################
preview_delete=product.PreviewDeleteController
preview=product.PreviewController
pdetail=product.PdetailController
previewupdate=product.PreviewUpdateController
plist=product.PlistController
pdelete=product.PdeleteController
pcategorylist=product.PcategorylistController
#### Mall Section ######################################################
mallcartadd=Mall.MallCartAddController
mallcartlist=Mall.MallCartListController
mallcartdelete=Mall.MallCartDeleteItemController
mallhistory=Mall.MallHistoryController
mallhistoryregular=Mall.MallHistoryRegularController
mallDetailregular=Mall.MallRegularDetailController
mallDetail=Mall.MallDetailController
#### Payment Section ###############################
payment=member.Addresscontroller
paymentaddaddr=payments.PaymentShippingController
paymentcoupon=payments.CouponSelectController
